GTTGCTGTAGCATTCTGGTAGGACATCAAGAAATGGTTAAAAGCCGTCGT	AGGCATCTACCCTCCTCACGGAATTAGCTGGGCAACGTAGTGAGACCGGA
TCACGGAATCGTTCCCACTAATTCTCTAGATATGCCATCATACTCAGTAC	GAAATTACCTAAATTATAGGTGGGTTGCGATGGGATTGAGCCGCACATTC
GGCTCATCAGCCCTCAGTCAGACCTTCCCGTAGACGACCAGTAGAAGGCA	CCGCCTCCTAGGCAAGCAGATACCGCCATGGGGGACCGTTGGGATTTACC
GAGCCTGGCTAAACCCAGCCCTTGCCGATCTGGCATACCATGAGACAGGC	TCTGATGTCTGTCCTGGATCTACCTAGCCTGATTCCATGCGTCGTACATC
GGAAGATTTTCACCCAATGAGTATGTGTCGGGGTAGCTTCTTCAAGCCGG	TATCGAATCTCAGGATATGGGGGGTAGGTCCGCATCCTCAATGATTGTAG
ACAGATGGAGATCAAGTGTCCAACCCCTATTAATCTAGATTAAATGATAT	CCTGCAGCCGCTGCGGAAGCATGCCGGAATATTAAACTATGCATTTGAGC
TTATATACATATCGTTGTCTATGCGGGTTGGAGCTTCCGTATACAGCAGG	GGCCACGGGAGTTAGTACCAGGCTCTTTACCTACTTTAACGAGATTCATT
GGGTTTCCTTGGTGGTGGTATTTAGATTACAACGCTGGACCGCATCTCCT	AGAGGGTGCATGGTACAAACCCTTGGGATACCCGAGTGCGCGCCGCTCGC
ATACTCAAACTAACAAGGCCCTAGGTTTTTAAGCCTCCTTCTATTGAACA	GTGACAGGGCAAAGCCGAGGGACACGAATCTGATGAACTTAATAAAAACT
CGAGTGCACCAAGATCTATGTTCGTACCATCGCAAGCAATCGAATAGGAG	TTTTGTTATACGCGTATGGGCGACAAGGCACTGGGGTCCAGTAATCCGGT
AAAGACGCGTGTCGTCGCTGTTAGGCATTCTTTATATGCTGTGGTGCCTT	GAAATTTCTCGATCGGATAGAGGTTAACACGGACATCCGGGTGGACTGGT
GTGAGGTAGGGCACCTTCGTATGCCAATTAGCTGTCATCCGACTGTCGGA	GTGTAGAACTACCTGGTAACAGCAATCCCCCCATATGCTAGTATGGCTCC
GCTTTCACGGCAGTTTTTTGGTAGGAAGCATTTATTAGAAGTCCTCTGCC	GGGAGCTTCTGCGGCGTCCTAATCCCTATCACAAACCCAGGAGTGATCTG
CAATTGTGAGTTCCGCTTCGTTCATCTTAGTGCATTGACCAGATGTTAGC	GGATAGGGGCTCCCTTCCCGCCTGTCCCGACAACACATCAGAGTTACAAC
CCACTTTTATCGCCAATAAGTCTTGCCCCGATAGGCAACCATGGGTCATG	CATCCCGGATTATTCCACACGTGCCAACAGAGGCGGGGACCGTGCCAACC
GGCCGCCCGGCGGTAGTCCTACTGTTCCACCCGCTTCAGCCAGTCCACCC	GCCATCCATCGACGGGAGAGGACTACGCTGTAATAACGTAGGACCTGTCA
CAAAGCTGAATGAAAGACTCAAATGAGAGTTTGTGCCGCTAGCGAGAAGT	GTGCTTAGGACAGACAATTTAGGGGTTCCACATATAAGGCAGACACCAAA
TCTCCAGCCATGTCAAGGTGTACAGGCCTAGAACCGTTGTCAGGGGTTGG	ATTGACCGGGTTGACGAGTTTTTACGTGCATATTTTCACACACCTACGAT
GCCGCTAATGGTCAGTGGTGTCTCGCGCTCCAGGTAAAAATGGATTCTAG	GCCTAACTTTGCATGCTTATAAGGCGGTCTGGTGCGGTATTTGTGTCGGG
CTCGCGGGTCCTATATTCTGACGATGAGTGGACACCACACTACTCCCACA	AATAATAGCCCTGATTATTTAACAGCTGCTAGAGTAGCTTTTGTGCGCCT